4_1_1_1_1_1_1_1_1_1_1_1_1_1_1_1_1_1_1_1_1_1_1_1_1_1_1_1_1_1_1_1_1
1_1_1_1_1_1_1_1_1_1_1_1_1_1_1_1_1_1_1_1_1_1_1_1_1_1_1_1_1_1_1_1_1
2_2_2_2_2_2_2_2_2_2_2_2_2_2_2_2_2_2_1_1_2_2_2_2_2_2_2_2_2_2_2_2_2
1_1_1_1_1_1_1_1_1_1_1_1_1_1_1_1_1_1_1_1_1_1_1_1_1_1_1_1_1_1_1_1_1
1_1_1_1_1_1_1_1_1_1_1_1_1_1_1_1_1_1_1_1_1_1_1_1_1_1_1_1_1_1_1_1_1
3_3_1_1_1_1_1_1_1_1_1_1_1_1_1_1_3_3_3_1_1_1_1_1_1_1_1_1_1_1_1_1_1
2_2_2_1_1_1_2_2_2_2_2_2_2_2_2_2_2_2_2_1_1_1_2_2_2_2_2_2_2_2_2_2_2
1_1_1_1_1_1_1_1_1_1_1_1_1_1_1_1_1_1_1_1_1_1_1_1_1_1_1_1_1_1_1_1_1
1_1_1_1_1_1_1_1_1_1_1_1_1_1_1_1_1_1_1_1_1_1_1_1_1_1_1_1_1_1_1_1_1
1_1_1_1_1_1_1_1_1_1_1_1_1_1_1_1_1_1_1_1_3_3_3_3_3_3_3_1_1_1_1_1_1
2_2_2_2_2_2_2_2_2_2_2_1_1_1_2_2_2_2_2_2_2_2_2_2_2_2_2_2_2_2_2_2_2
1_1_1_1_1_1_1_1_1_1_1_1_1_1_1_1_1_1_1_1_1_1_1_1_1_1_1_1_1_1_1_1_1
3_3_1_1_1_1_1_1_1_1_1_1_1_1_1_1_1_1_1_1_1_1_1_1_1_1_1_1_1_1_1_1_1
1_1_1_1_2_2_2_2_2_2_2_2_2_2_2_2_2_2_2_2_2_2_2_2_2_2_2_2_2_2_2_2_2
1_1_1_1_1_1_1_1_1_1_1_1_1_1_1_1_1_1_1_1_1_3_3_3_3_3_3_3_3_3_3_3_3
3_3_3_3_3_3_3_3_3_3_3_3_3_3_3_3_3_3_3_3_3_3_3_3_3_3_3_3_3_3_3_3_3